11 11 11 11 11 11 11 11 11 11 11 11 11 11 11 11 11 11 11 11 11 11 11 11 11 11 11 11 11 11 11 11
11 11 11 11 11 11 11 11 11 11 11 11 11 11 11 11 11 11 11 11 11 11 11 11 11 11 11 11 11 11 11 11
11 11 11 11 11 11 11 11 11 11 11 11 11 11 11 11 11 11 11 11 11 11 11 11 11 11 11 11 11 11 11 11
11 11 11 11 11 11 11 11 11 11 11 11 11 11 11 11 11 11 11 11 11 11 11 11 11 11 11 11 11 11 11 11
11 11 11 11 11 11 11 11 11 11 11 11 11 11 11 11 11 11 11 11 11 11 11 11 11 11 11 11 11 11 11 11
11 11 11 11 11 11 11 11 11 11 8 10 10 10 10 10 10 10 10 10 10 9 11 11 11 11 11 11 11 11 11 11
11 11 11 11 11 11 11 11 11 11 6 0 0 0 0 0 0 0 0 0 0 7 11 11 11 11 11 11 11 11 11 11
11 11 11 11 11 11 11 11 11 11 6 0 0 0 0 0 0 0 0 0 0 7 11 11 11 11 11 11 11 11 11 11
11 11 11 11 11 11 11 11 11 11 6 0 0 0 0 0 0 0 0 0 0 7 11 11 11 11 11 11 11 11 11 11
11 11 11 11 11 11 11 11 11 11 6 0 0 0 0 0 0 0 0 0 0 7 11 11 11 11 11 11 11 11 11 11
11 11 11 11 11 11 11 11 11 11 6 0 0 0 0 0 0 0 0 0 0 7 11 11 11 11 11 11 11 11 11 11
11 11 11 11 11 11 11 11 11 11 6 0 0 0 0 0 0 0 0 0 0 7 11 11 11 11 11 11 11 11 11 11
11 11 11 11 11 11 11 11 11 11 6 0 0 0 0 0 0 0 0 0 0 7 11 11 11 11 11 11 11 11 11 11
11 11 11 11 11 11 11 11 11 11 6 0 0 0 0 0 0 0 0 0 0 7 11 11 11 11 11 11 11 11 11 11
11 11 11 11 11 11 11 11 11 11 6 0 0 0 0 0 0 0 0 0 0 7 11 11 11 11 11 11 11 11 11 11
11 11 11 11 11 11 11 11 11 11 6 0 0 0 0 0 0 0 0 0 0 7 11 11 11 11 11 11 11 11 11 11
11 11 11 11 11 11 11 11 11 11 6 0 0 0 0 0 0 0 0 0 0 7 11 11 11 11 11 11 11 11 11 11
11 11 11 11 11 11 11 11 11 11 6 0 0 0 0 0 0 0 0 0 0 7 11 11 11 11 11 11 11 11 11 11
11 11 11 11 11 11 11 11 11 11 6 0 0 0 0 0 0 0 0 0 0 7 11 11 11 11 11 11 11 11 11 11
11 11 11 11 11 11 11 11 11 11 6 0 0 0 0 0 0 0 0 0 0 7 11 11 11 11 11 11 11 11 11 11
11 11 11 11 11 11 11 11 11 11 6 0 0 0 0 0 0 0 0 0 0 7 11 11 11 11 11 11 11 11 11 11
11 11 11 11 11 11 11 11 11 11 6 0 0 0 0 0 0 0 0 0 0 7 11 11 11 11 11 11 11 11 11 11
11 11 11 11 11 11 11 11 11 11 6 0 0 0 0 0 0 0 0 0 0 7 11 11 11 11 11 11 11 11 11 11
11 11 11 11 11 11 11 11 11 11 6 0 0 0 0 0 0 0 0 0 0 7 11 11 11 11 11 11 11 11 11 11
11 11 11 11 11 11 11 11 11 11 6 0 0 0 0 0 0 0 0 0 0 7 11 11 11 11 11 11 11 11 11 11
11 11 11 11 11 11 11 11 11 11 6 0 0 0 0 0 0 0 0 0 0 7 11 11 11 11 11 11 11 11 11 11
11 11 11 11 11 11 11 11 11 11 6 0 0 0 0 0 0 0 0 0 0 7 11 11 11 11 11 11 11 11 11 11
11 11 11 11 11 11 11 11 11 11 6 0 0 0 0 0 0 0 0 0 0 7 11 11 11 11 11 11 11 11 11 11
11 11 11 11 11 11 11 11 11 11 6 0 0 0 0 0 0 0 0 0 0 7 11 11 11 11 11 11 11 11 11 11
11 11 11 11 11 11 11 11 11 11 6 0 0 0 0 0 0 0 0 0 0 7 11 11 11 11 11 11 11 11 11 11
11 11 11 11 11 11 11 11 11 11 6 0 0 0 0 0 0 0 0 0 0 7 11 11 11 11 11 11 11 11 11 11
11 11 11 11 11 11 11 11 11 11 6 0 0 0 0 0 0 0 0 0 0 7 11 11 11 11 11 11 11 11 11 11
11 11 11 11 11 11 11 11 11 11 6 0 0 0 0 0 0 0 0 0 0 7 11 11 11 11 11 11 11 11 11 11
11 11 11 11 11 11 11 11 11 11 6 0 0 0 0 0 0 0 0 0 0 7 11 11 11 11 11 11 11 11 11 11
11 11 11 11 11 11 11 11 11 11 6 0 0 0 0 0 0 0 0 0 0 7 11 11 11 11 11 11 11 11 11 11
11 11 11 11 11 11 11 11 11 11 6 0 0 0 0 0 0 0 0 0 0 7 11 11 11 11 11 11 11 11 11 11
11 11 11 11 11 11 11 11 11 11 6 0 0 0 0 0 0 0 0 0 0 7 11 11 11 11 11 11 11 11 11 11
11 11 11 11 11 11 11 11 11 11 6 0 0 0 0 0 0 0 0 0 0 7 11 11 11 11 11 11 11 11 11 11
11 11 11 11 11 11 11 11 11 11 6 0 0 0 0 0 0 0 0 0 0 7 11 11 11 11 11 11 11 11 11 11
11 11 11 11 11 11 11 11 11 11 6 0 0 0 0 0 0 0 0 0 0 7 11 11 11 11 11 11 11 11 11 11
11 11 11 11 11 11 11 11 11 11 6 0 0 0 0 0 0 0 0 0 0 7 11 11 11 11 11 11 11 11 11 11
11 11 11 11 11 11 11 11 11 11 6 0 0 0 0 0 0 0 0 0 0 7 11 11 11 11 11 11 11 11 11 11
11 11 11 11 11 11 11 11 11 11 6 0 0 0 0 0 0 0 0 0 0 7 11 11 11 11 11 11 11 11 11 11
11 11 11 11 11 11 11 11 11 11 6 0 0 0 0 0 0 0 0 0 0 7 11 11 11 11 11 11 11 11 11 11
11 11 11 11 11 11 11 11 11 11 6 0 0 0 0 0 0 0 0 0 0 7 11 11 11 11 11 11 11 11 11 11
11 11 11 11 11 11 11 11 11 11 6 0 0 0 0 0 0 0 0 0 0 7 11 11 11 11 11 11 11 11 11 11
11 11 11 11 11 11 11 11 11 11 6 0 0 0 0 0 0 0 0 0 0 7 11 11 11 11 11 11 11 11 11 11
11 11 11 11 11 11 11 11 11 11 6 0 0 0 0 0 0 0 0 0 0 7 11 11 11 11 11 11 11 11 11 11
11 11 11 11 11 11 11 11 11 11 6 0 0 0 0 0 0 0 0 0 0 7 11 11 11 11 11 11 11 11 11 11
11 11 11 11 11 11 11 11 11 11 6 0 0 0 0 0 0 0 0 0 0 7 11 11 11 11 11 11 11 11 11 11
11 11 11 11 11 11 11 11 11 11 6 0 0 0 0 0 0 0 0 0 0 7 11 11 11 11 11 11 11 11 11 11
11 11 11 11 11 11 11 11 11 11 6 0 0 0 0 0 0 0 0 0 0 7 11 11 11 11 11 11 11 11 11 11
11 11 11 11 11 11 11 11 11 11 6 0 0 0 0 0 0 0 0 0 0 7 11 11 11 11 11 11 11 11 11 11
11 11 11 11 11 11 11 11 11 11 6 0 0 0 0 0 0 0 0 0 0 7 11 11 11 11 11 11 11 11 11 11
11 11 11 11 11 11 11 11 11 11 6 0 0 0 0 0 0 0 0 0 0 7 11 11 11 11 11 11 11 11 11 11
11 11 11 11 11 11 11 11 11 11 6 0 0 0 0 0 0 0 0 0 0 7 11 11 11 11 11 11 11 11 11 11
11 11 11 11 11 11 11 11 11 11 6 0 0 0 0 0 0 0 0 0 0 7 11 11 11 11 11 11 11 11 11 11
11 11 11 11 11 11 11 11 11 11 6 0 0 0 0 0 0 0 0 0 0 7 11 11 11 11 11 11 11 11 11 11
11 11 11 11 11 11 11 11 11 11 6 0 0 0 0 0 0 0 0 0 0 7 11 11 11 11 11 11 11 11 11 11
11 11 11 11 11 11 11 11 11 11 6 0 0 0 0 0 0 0 0 0 0 7 11 11 11 11 11 11 11 11 11 11
11 11 11 11 11 11 11 11 11 11 6 0 0 0 0 0 0 0 0 0 0 7 11 11 11 11 11 11 11 11 11 11
11 11 11 11 11 11 11 11 11 11 6 0 0 0 0 0 0 0 0 0 0 7 11 11 11 11 11 11 11 11 11 11
11 11 11 11 11 11 11 11 11 11 6 0 0 0 0 0 0 0 0 0 0 7 11 11 11 11 11 11 11 11 11 11
11 11 11 11 11 11 11 11 11 11 6 0 0 0 0 0 0 0 0 0 0 7 11 11 11 11 11 11 11 11 11 11
11 11 11 11 11 11 11 11 11 11 6 0 0 0 0 0 0 0 0 0 0 7 11 11 11 11 11 11 11 11 11 11
11 11 11 11 11 11 11 11 11 11 6 0 0 0 0 0 0 0 0 0 0 7 11 11 11 11 11 11 11 11 11 11
11 11 11 11 11 11 11 11 11 11 6 0 0 0 0 0 0 0 0 0 0 7 11 11 11 11 11 11 11 11 11 11
11 11 11 11 11 11 11 11 11 11 6 0 0 0 0 0 0 0 0 0 0 7 11 11 11 11 11 11 11 11 11 11
11 11 11 11 11 11 11 11 11 11 6 0 0 0 0 0 0 0 0 0 0 7 11 11 11 11 11 11 11 11 11 11
11 11 11 11 11 11 11 11 11 11 6 0 0 0 0 0 0 0 0 0 0 7 11 11 11 11 11 11 11 11 11 11
11 11 11 11 11 11 11 11 11 11 6 0 0 0 0 0 0 0 0 0 0 7 11 11 11 11 11 11 11 11 11 11
11 11 11 11 11 11 11 11 11 11 6 0 0 0 0 0 0 0 0 0 0 7 11 11 11 11 11 11 11 11 11 11
11 11 11 11 11 11 11 11 11 11 6 0 0 0 0 0 0 0 0 0 0 7 11 11 11 11 11 11 11 11 11 11
11 11 11 11 11 11 11 11 11 11 6 0 0 0 0 0 0 0 0 0 0 7 11 11 11 11 11 11 11 11 11 11
11 11 11 11 11 11 11 11 11 11 6 0 0 0 0 0 0 0 0 0 0 7 11 11 11 11 11 11 11 11 11 11
11 11 11 11 11 11 11 11 11 11 6 0 0 0 0 0 0 0 0 0 0 7 11 11 11 11 11 11 11 11 11 11
11 11 11 11 11 11 11 11 11 11 6 0 0 0 0 0 0 0 0 0 0 7 11 11 11 11 11 11 11 11 11 11
11 11 11 11 11 11 11 11 11 11 6 0 0 0 0 0 0 0 0 0 0 7 11 11 11 11 11 11 11 11 11 11
11 11 11 11 11 11 11 11 11 11 6 0 0 0 0 0 0 0 0 0 0 7 11 11 11 11 11 11 11 11 11 11
11 11 11 11 11 11 11 11 11 11 6 0 0 0 0 0 0 0 0 0 0 7 11 11 11 11 11 11 11 11 11 11
11 11 11 11 11 11 11 11 11 11 6 0 0 0 0 0 0 0 0 0 0 7 11 11 11 11 11 11 11 11 11 11
11 11 11 11 11 11 11 11 11 11 6 0 0 0 0 0 0 0 0 0 0 7 11 11 11 11 11 11 11 11 11 11
11 11 11 11 11 11 11 11 11 11 6 0 0 0 0 0 0 0 0 0 0 7 11 11 11 11 11 11 11 11 11 11
11 11 11 11 11 11 11 11 11 11 6 0 0 0 0 0 0 0 0 0 0 7 11 11 11 11 11 11 11 11 11 11
11 11 11 11 11 11 11 11 11 11 6 0 0 0 0 0 0 0 0 0 0 7 11 11 11 11 11 11 11 11 11 11
11 11 11 11 11 11 11 11 11 11 6 0 0 0 0 0 0 0 0 0 0 7 11 11 11 11 11 11 11 11 11 11
11 11 11 11 11 11 11 11 11 11 6 0 0 0 0 0 0 0 0 0 0 7 11 11 11 11 11 11 11 11 11 11
11 11 11 11 11 11 11 11 11 11 6 0 0 0 0 0 0 0 0 0 0 7 11 11 11 11 11 11 11 11 11 11
11 11 11 11 11 11 11 11 11 11 6 0 0 0 0 0 0 0 0 0 0 7 11 11 11 11 11 11 11 11 11 11
11 11 11 11 11 11 11 11 11 11 6 0 0 0 0 0 0 0 0 0 0 7 11 11 11 11 11 11 11 11 11 11
11 11 11 11 11 11 11 11 11 11 6 0 0 0 0 0 0 0 0 0 0 7 11 11 11 11 11 11 11 11 11 11
11 11 11 11 11 11 11 11 11 11 6 0 0 0 0 0 0 0 0 0 0 7 11 11 11 11 11 11 11 11 11 11
11 11 11 11 11 11 11 11 11 11 6 0 0 0 0 0 0 0 0 0 0 7 11 11 11 11 11 11 11 11 11 11
11 11 11 11 11 11 11 11 11 11 6 0 0 0 0 0 0 0 0 0 0 7 11 11 11 11 11 11 11 11 11 11
11 11 11 11 11 11 11 11 11 11 3 5 5 5 5 5 5 5 5 5 5 4 11 11 11 11 11 11 11 11 11 11
11 11 11 11 11 11 11 11 11 11 11 11 11 11 11 11 11 11 11 11 11 11 11 11 11 11 11 11 11 11 11 11
11 11 11 11 11 11 11 11 11 11 11 11 11 11 11 11 11 11 11 11 11 11 11 11 11 11 11 11 11 11 11 11
11 11 11 11 11 11 11 11 11 11 11 11 11 11 11 11 11 11 11 11 11 11 11 11 11 11 11 11 11 11 11 11
11 11 11 11 11 11 11 11 11 11 11 11 11 11 11 11 11 11 11 11 11 11 11 11 11 11 11 11 11 11 11 11
11 11 11 11 11 11 11 11 11 11 11 11 11 11 11 11 11 11 11 11 11 11 11 11 11 11 11 11 11 11 11 11